r r r r - y y y y y
r r r r r r r r r r
b b - - b b b b b b
x x x x x x - x x -
- - - - - - - - - -