r r r r - y y y y y
r r r r r b r r r x
b b - - b b b b b b
x x x x x x - x x -
- - - - - - - - - -